1111111111111111111111111111
1000000000000000000000000001
10C0000000000000C01100000001
1000000111100000000000111001
10000001C010010C0100000C1001
10P000000H000111110000111001
11100C11000001E0010000000001
101000000000000000000000C001
1111111111111111111111111111